*************
*G*_________*
*_*_*******_*
*_*_*_______*
*_*_*_*******
*_*_*_*_____*
*_*_*_*_***_*
*___*___*___*
*********_***
*__P*___*___*
*_***_*_***_*
*_____*_____*
*************