*************
*P__________*
***********_*
*_________*_*
*_*******_*_*
*_______*___*
*******_*****
*_______*___*
*_*******_*_*
*_*G______*_*
*_*********_*
*___________*
*************